wwwwwwww
......t.
........
........
rrrsrrsr
........
.....c..
.t......
